{
  "width": 20,
  "height": 20,
  "map": [
    "11111111111111111111",
    "10000000000000000001",
    "10111111110111111001",
    "10000000000100001001",
    "10111111110101111001",
    "10000000000100001001",
    "10111110111101111001",
    "10000000000000001001",
    "10111110101111111001",
    "10000010001000001001",
    "10111110101111111001",
    "10000010001000001001",
    "10111110101111111001",
    "10000010001000001001",
    "10111110101111111001",
    "10000010001000001001",
    "10111110101111111001",
    "10000010001000001001",
    "10111110101111111001",
    "10000000000000000001",
    "11111111111111111111"
  ]
}
