{
    "width": 20,
    "height": 20,
    "map": [
      "11111111111111111111",
      "10000000000003330001",
      "10011100000000000001",
      "10030000000000000001",
      "10020000000000300001",
      "10020001110000000001",
      "10000330000000000001",
      "10000330000000000001",
      "10000330000000000001",
      "10000330000000000001",
      "10000330000000000001",
      "10000330000000000001",
      "10020000000000300001",
      "10020001110000000001",
      "10000330000000000001",
      "10000330000000000001",
      "10020000000000300001",
      "10020001110000000001",
      "10000330000000000001",
      "11111111111111111111"
    ]
  }